33 33 33 33 33 33 33 33 33 33 33 33 33 33 32 22 36 36 36 36 36 36 36 36 36 36 36 18 32 32 32 32 32 32 32 32 32 32 32 32 32 32 32 32 32 32 32 32 32 27 19 19 19 59 26 19 59 36 36 36 36 36 36 36 36 36 36 36 36 36 36 36 36 36 36 36 36 36 36 36 1
33 72 70 33 70 70 70 70 70 70 70 70 70 33 32 22 36 36 36 36 36 36 36 36 36 36 36 18 00 00 00 01 01 32 72 00 00 00 00 00 00 00 00 00 00 00 00 00 32 32 32 32 32 22 18 01 27 19 19 19 19 19 19 19 19 19 19 19 19 19 59 36 35 36 36 35 35 36 36 36 2
33 33 70 33 70 70 70 70 70 70 70 70 70 33 32 22 36 36 36 36 36 36 36 36 36 36 36 18 00 32 00 01 00 00 32 00 00 00 00 00 00 00 00 00 00 00 33 33 33 33 33 33 32 22 18 01 01 01 01 01 01 01 01 01 01 01 01 01 01 01 27 19 19 59 36 35 36 36 36 36 3
33 33 70 70 70 70 70 70 70 70 70 70 70 33 32 27 19 19 19 19 19 19 19 19 19 19 19 23 00 01 01 01 00 32 00 00 00 11 12 13 00 00 00 00 00 00 33 00 00 00 00 33 32 22 18 01 64 62 62 62 62 62 62 62 62 62 62 62 65 01 01 01 01 22 36 36 36 35 36 36 4
33 33 70 70 70 70 70 70 70 70 70 70 70 33 32 32 32 32 32 32 32 32 32 32 32 32 32 32 00 01 32 00 00 00 32 00 00 14 15 16 00 00 00 00 00 00 33 00 00 00 00 33 32 22 18 01 69 60 60 10 60 60 60 60 60 60 10 60 10 62 62 65 01 27 19 59 35 36 36 36 5
33 33 70 70 70 70 70 70 70 70 70 70 70 33 32 32 32 32 32 32 32 32 32 32 32 32 32 32 00 01 01 01 00 32 00 00 00 00 00 00 00 00 00 00 00 00 33 00 00 00 00 33 32 22 18 01 69 60 60 60 60 60 10 10 60 60 60 60 60 60 60 67 01 01 01 22 35 36 36 36 6
33 33 70 70 70 70 70 70 70 70 70 70 70 33 32 32 00 00 32 32 00 00 32 00 00 32 32 32 00 32 00 01 00 00 32 00 00 00 00 00 00 00 00 00 00 00 01 00 00 00 00 33 32 22 18 01 69 60 60 60 10 60 60 60 60 60 60 60 60 60 60 10 62 65 01 22 35 36 36 36 7
33 33 70 70 70 70 70 70 70 70 70 70 70 33 32 32 00 00 32 32 00 00 32 00 00 32 32 32 00 01 01 01 00 32 00 00 00 00 00 00 00 00 00 00 00 00 33 33 33 33 33 33 32 22 18 01 69 60 60 60 60 60 60 60 60 60 60 10 60 60 60 60 60 67 01 27 59 36 36 36 8
33 33 70 70 70 70 70 70 70 70 70 70 70 33 32 32 00 00 32 32 00 00 32 00 00 32 32 32 00 01 32 00 00 00 32 00 00 00 00 00 00 00 00 00 00 00 00 00 32 32 32 32 32 22 18 01 69 60 60 60 60 60 60 10 60 60 10 60 60 60 60 10 60 67 01 01 22 36 36 36 9
33 33 70 70 70 70 70 70 70 70 70 70 70 33 32 32 00 00 32 32 00 00 32 00 00 32 32 32 00 01 01 01 00 00 00 32 00 00 00 00 00 00 00 00 00 00 00 00 32 20 21 21 21 25 18 01 69 10 60 60 60 60 60 60 10 60 60 60 60 60 60 60 60 10 65 01 22 36 36 36 10
33 33 70 70 70 70 70 70 70 70 70 70 70 33 32 72 00 00 00 00 00 00 01 00 00 01 01 01 00 32 00 01 00 00 00 00 32 00 00 00 00 00 11 12 13 00 00 00 32 22 26 19 19 19 23 01 69 60 60 60 60 60 60 60 60 60 60 60 60 60 60 60 60 60 67 01 22 36 36 36 11
33 33 33 70 70 70 70 70 70 70 33 33 70 33 32 32 00 00 32 32 00 00 32 00 00 32 32 32 00 01 01 01 00 00 00 00 00 32 00 00 00 00 14 15 16 00 00 00 32 22 18 01 01 01 01 01 69 60 60 10 60 60 60 60 10 60 60 60 60 60 10 60 10 60 67 01 22 36 36 36 12
21 24 33 70 70 70 70 70 70 70 33 70 70 33 32 32 00 00 32 32 00 00 32 00 00 32 32 32 00 01 32 00 00 00 00 00 00 00 32 00 00 00 00 00 00 00 00 00 32 22 18 01 00 00 00 64 10 60 60 60 60 60 60 60 60 60 60 60 60 60 60 60 60 60 67 01 22 36 36 36 13
36 18 33 33 33 33 33 33 33 33 33 72 33 33 32 32 00 00 32 32 00 00 32 00 00 32 32 32 00 01 01 01 00 00 00 00 00 00 00 32 00 00 00 00 00 00 00 00 01 06 08 01 00 00 00 69 60 60 60 60 60 10 60 60 60 60 60 60 60 60 60 60 10 60 67 01 22 36 36 36 14
35 18 32 32 32 32 32 32 32 32 32 32 32 32 32 32 00 00 32 32 00 00 32 00 00 32 32 32 00 00 32 01 00 00 00 00 00 00 00 00 32 00 00 00 00 00 00 00 01 07 09 01 00 00 00 63 68 68 68 60 60 60 60 60 60 60 60 60 60 60 60 60 60 60 67 01 22 36 36 36 15
35 17 21 24 32 00 00 00 00 00 00 00 00 00 00 32 00 00 32 32 00 00 32 00 00 32 32 32 00 01 01 01 00 00 00 00 00 00 00 00 00 32 00 00 00 00 00 00 32 22 18 01 01 01 01 01 01 01 01 69 60 60 60 60 60 34 34 60 34 34 60 60 60 10 67 01 22 36 36 36 16
35 35 35 18 32 00 00 00 00 00 00 00 00 00 00 32 32 32 32 32 32 32 32 32 32 32 32 32 00 01 32 00 00 00 00 00 00 00 00 00 00 00 32 00 00 00 00 00 32 22 17 21 21 21 21 21 21 24 01 69 60 60 60 60 34 10 10 60 10 10 34 60 60 60 67 01 22 36 36 36 17
35 35 35 18 32 00 00 37 38 39 40 41 42 43 00 00 32 32 32 32 32 32 32 32 32 32 32 32 00 01 01 01 00 00 00 00 00 00 00 00 00 00 00 32 00 00 00 00 32 27 19 19 19 19 19 19 59 18 01 69 60 60 60 60 34 60 60 60 60 60 34 60 00 60 67 01 22 36 36 36 18
35 35 35 18 32 00 00 44 36 36 35 36 36 45 00 00 00 00 00 00 00 00 00 00 00 00 00 00 00 00 32 01 32 32 32 32 32 01 32 32 32 32 32 00 32 32 32 32 32 00 71 71 71 71 71 71 22 18 01 69 60 60 60 60 34 60 10 60 10 60 34 60 60 60 67 01 22 36 36 36 19
35 35 35 18 32 00 00 46 36 35 36 36 36 47 00 00 00 00 00 00 00 00 00 00 00 00 00 00 00 01 01 01 32 00 00 00 00 01 00 00 00 00 32 00 00 00 00 00 00 00 71 71 71 71 71 71 22 18 01 69 60 34 34 34 34 60 60 60 60 60 34 34 34 34 67 01 22 36 36 36 20
35 35 35 18 32 00 00 48 36 36 35 35 36 49 00 00 32 00 32 00 32 00 32 00 32 00 32 00 32 01 32 00 32 00 00 00 00 01 00 00 00 00 32 00 00 00 00 00 00 00 71 71 71 71 71 71 22 18 01 69 60 34 10 60 10 60 10 60 10 60 10 60 10 34 67 01 22 36 36 36 21
35 35 35 18 32 00 00 50 36 36 36 35 36 51 00 00 00 00 00 00 00 00 00 00 00 00 00 00 00 01 01 01 32 00 00 00 00 01 00 00 00 00 32 00 00 00 00 00 00 00 71 71 71 71 71 71 22 18 01 69 10 34 60 60 60 60 60 60 60 60 60 60 60 34 67 01 27 19 59 36 22
35 35 35 18 32 00 00 52 53 54 55 56 57 58 00 00 32 00 32 00 32 00 32 00 32 00 32 00 32 00 32 01 32 00 00 00 00 01 00 00 00 00 32 00 00 00 00 00 00 00 71 71 71 71 71 71 22 18 01 69 60 34 10 60 10 60 10 60 10 60 10 60 10 34 67 01 01 01 22 36 23
19 19 19 23 32 00 00 00 00 00 00 00 00 00 00 00 00 00 00 00 00 00 00 00 00 00 00 00 00 01 01 01 01 01 01 01 01 01 01 01 01 01 01 00 00 00 00 00 00 00 00 00 00 00 20 21 25 18 01 69 60 34 60 60 60 60 60 60 60 60 60 60 60 34 60 62 65 01 22 36 24
32 32 32 32 32 00 00 00 00 00 00 00 00 00 00 00 32 00 32 00 32 00 32 00 32 00 32 00 32 01 32 00 32 00 00 00 00 01 00 00 00 00 32 00 00 00 00 00 00 00 00 00 00 00 22 26 19 23 01 69 60 34 10 60 10 60 10 60 10 60 10 60 10 34 60 60 67 01 22 36 25
32 32 32 32 32 00 00 37 38 39 40 41 42 43 00 00 00 00 00 00 00 00 00 00 00 00 00 00 00 01 01 01 32 00 00 00 00 01 00 00 00 00 32 00 00 00 00 00 00 00 00 00 00 00 22 18 01 01 01 69 60 34 60 60 60 60 60 60 60 60 60 60 60 34 60 10 67 01 22 36 26
32 32 32 32 32 00 00 44 35 36 36 36 35 45 00 00 32 00 32 00 32 00 32 00 32 00 32 00 32 00 32 01 32 00 00 00 00 01 00 00 00 00 32 00 00 00 00 00 00 00 00 00 00 00 06 08 01 64 62 60 10 34 10 60 10 60 10 60 10 60 10 60 10 34 60 60 67 01 22 36 27
32 32 32 32 32 00 00 46 36 36 36 36 36 47 00 00 00 00 00 00 00 00 00 00 00 00 00 00 00 01 01 01 32 00 00 00 00 01 00 00 00 00 32 00 00 00 00 00 00 00 00 00 00 00 07 09 01 63 68 68 68 34 34 34 34 60 60 60 60 60 34 34 34 34 60 60 67 01 22 36 28
32 32 32 32 32 00 00 48 35 36 36 36 36 49 00 00 32 00 32 00 32 00 32 00 32 00 32 00 32 01 32 00 32 32 32 32 32 01 32 32 32 32 32 00 00 00 00 00 00 00 00 00 00 00 22 18 01 01 01 01 01 01 01 69 34 60 10 60 10 60 34 60 60 60 60 10 67 01 27 59 29
32 32 32 32 32 00 00 50 36 36 36 35 36 51 00 00 00 00 00 00 00 00 00 00 00 00 00 00 00 01 01 01 00 00 00 00 32 00 32 32 32 32 32 32 32 32 32 32 32 32 32 32 32 00 22 17 21 21 21 21 21 24 01 69 34 60 60 60 60 60 34 60 60 60 60 10 10 65 01 22 30
32 32 32 32 32 00 00 52 53 54 55 56 57 58 00 00 32 00 32 00 32 00 32 00 32 00 32 00 32 00 32 01 00 00 00 00 32 00 00 00 00 00 00 00 00 00 00 00 00 00 00 00 32 00 27 19 19 19 19 19 59 18 01 69 34 34 10 60 10 34 34 60 60 60 60 60 60 67 01 22 31
32 32 32 32 32 32 01 01 01 01 01 01 01 01 01 01 00 00 00 00 00 00 00 00 00 00 00 00 00 01 01 01 00 00 00 00 32 32 32 32 32 32 32 32 32 32 32 32 32 32 32 00 32 00 00 00 00 00 00 00 22 18 01 69 60 34 34 60 34 34 60 60 60 60 60 60 60 67 01 22 32
32 32 32 32 01 01 01 01 01 01 01 01 01 01 01 01 00 00 00 00 32 00 32 00 32 00 32 00 32 01 32 00 00 00 00 00 00 00 00 00 00 00 00 00 00 00 00 00 00 00 32 00 32 00 00 00 00 00 00 00 22 18 01 69 60 60 60 34 60 60 60 10 60 60 10 60 60 67 01 22 33
32 32 32 32 01 01 32 32 32 32 32 32 32 32 32 32 32 32 00 00 00 00 00 00 00 00 00 00 00 01 01 01 00 32 32 32 32 32 32 32 32 32 32 32 32 32 32 32 32 32 32 00 32 00 00 00 00 00 00 00 22 18 01 69 60 60 60 60 60 60 60 60 10 60 60 60 60 67 01 22 34
32 32 32 32 01 01 32 32 32 00 00 32 00 00 32 32 32 32 00 00 32 00 32 00 32 00 32 00 32 00 32 01 00 32 00 00 00 00 00 00 00 00 00 00 00 00 00 00 00 00 00 00 32 00 00 00 00 00 00 00 22 18 01 69 10 60 60 10 60 60 60 60 60 60 60 60 10 67 01 22 35
32 32 32 32 01 01 32 32 00 00 00 32 00 00 00 32 32 32 00 00 00 00 00 00 00 00 00 00 00 01 01 01 00 32 00 32 32 32 32 32 32 32 32 32 32 32 32 32 32 32 32 32 32 32 32 32 00 00 00 00 22 18 01 63 68 68 68 68 68 68 68 68 68 68 68 68 68 66 01 22 36
32 32 32 32 01 01 32 00 00 32 32 00 32 32 00 00 32 32 00 00 32 00 32 00 32 00 32 00 32 01 32 00 00 32 00 00 00 00 00 00 00 00 00 00 00 00 00 00 00 00 00 00 00 00 00 32 00 00 00 00 22 18 01 01 01 01 01 01 01 01 01 01 01 01 01 01 01 01 01 22 37
32 32 32 32 01 01 32 00 00 32 32 00 32 32 00 00 32 32 00 00 00 00 00 00 00 00 00 00 00 01 01 01 00 32 32 32 32 32 32 32 32 32 32 32 32 32 32 32 32 32 32 32 32 32 00 32 32 32 32 00 22 17 21 21 02 03 21 21 21 21 21 24 01 11 12 13 01 01 01 22 38
32 32 32 32 01 01 32 00 00 32 32 32 32 32 00 00 32 32 00 00 32 00 32 00 32 00 32 00 32 00 32 01 00 32 00 00 00 00 00 00 00 00 00 00 00 00 00 00 00 00 00 00 00 00 00 00 00 00 32 00 27 19 19 19 04 05 19 19 19 19 59 18 01 14 15 16 01 01 01 22 39
32 32 32 32 01 01 32 32 00 32 32 32 32 32 00 32 32 32 00 00 00 00 00 00 00 00 00 00 00 01 01 01 00 32 32 32 32 32 00 32 32 32 32 32 32 32 32 32 32 32 32 32 32 32 32 32 32 00 00 00 00 00 00 00 00 00 00 00 00 00 22 18 01 01 01 01 01 01 01 22 40
32 32 32 32 01 01 32 32 32 00 32 32 32 00 32 32 32 32 00 00 00 00 00 00 00 00 00 00 00 01 32 00 00 00 32 00 00 00 00 00 00 00 00 00 00 00 00 00 00 00 00 00 00 00 00 32 32 32 32 00 00 00 00 00 00 00 00 00 00 00 22 18 01 01 01 01 01 01 01 22 41
32 32 32 32 01 01 32 32 32 32 00 00 00 32 32 32 32 32 00 00 00 00 00 00 00 00 00 00 00 01 01 01 32 32 32 32 32 32 32 32 32 32 32 00 32 32 32 32 32 32 32 32 32 32 00 32 00 00 00 00 00 00 00 00 00 00 00 00 00 00 22 18 01 01 01 01 20 21 21 25 42
32 32 32 32 01 01 32 32 32 32 32 00 32 32 32 32 32 32 32 32 32 32 32 32 32 32 32 01 32 00 32 01 32 00 00 00 00 00 00 00 00 00 00 00 00 00 32 32 00 00 00 00 00 32 00 32 00 00 00 00 00 00 00 00 00 00 00 00 00 00 22 18 01 01 01 01 22 36 36 36 43
21 21 21 21 02 03 21 21 21 21 21 21 21 21 24 00 00 00 00 00 00 00 00 00 32 00 00 00 32 01 01 01 32 32 32 32 32 32 32 00 32 32 32 32 32 32 00 00 00 00 00 00 00 32 00 32 01 01 01 01 01 01 01 01 01 01 01 00 00 00 22 17 21 21 21 21 25 36 36 36 44
19 19 19 19 04 05 19 19 19 19 19 19 19 59 18 00 00 00 00 00 00 00 00 00 32 00 32 32 32 01 32 00 00 00 00 00 00 00 32 00 32 00 00 00 32 00 32 32 32 32 32 32 32 00 00 32 01 20 21 21 21 21 21 21 21 24 01 00 00 00 27 19 19 19 19 19 59 36 36 36 45
32 01 01 01 01 01 01 01 01 01 01 01 01 22 18 00 00 00 00 00 00 00 00 00 32 00 32 00 32 01 01 01 00 00 00 00 00 00 32 00 00 00 32 32 00 00 00 00 00 00 00 00 00 00 32 01 01 22 36 35 36 36 36 35 36 18 01 00 00 00 00 00 00 00 00 00 22 36 36 36 46
32 01 32 32 32 32 32 32 32 32 32 32 01 22 18 00 00 00 00 00 00 00 00 00 32 00 32 32 32 00 32 01 00 00 00 00 00 00 32 32 00 32 00 00 00 00 00 00 00 00 00 00 00 32 01 20 21 25 36 36 36 36 36 36 36 18 01 00 00 00 00 00 00 00 00 00 22 36 36 36 47
32 01 32 32 32 01 32 32 32 32 32 32 01 22 18 00 00 00 00 00 00 00 00 00 00 00 00 00 32 01 01 01 00 00 00 00 00 00 32 00 00 32 32 32 00 00 00 00 00 00 00 00 00 00 01 22 36 36 36 36 36 36 36 36 36 18 01 00 00 00 00 00 00 00 00 00 22 36 36 36 48
32 01 32 32 01 01 01 01 01 01 01 32 01 06 08 00 00 00 00 00 00 00 00 00 00 00 00 00 32 01 32 00 00 00 00 00 00 00 32 01 01 32 01 01 01 01 01 01 00 00 00 00 00 00 01 22 36 36 36 36 36 36 36 36 36 18 01 00 00 00 00 00 00 00 00 00 22 36 36 36 49
32 01 32 32 01 32 32 32 32 32 01 32 01 07 09 00 00 00 00 00 00 00 00 00 00 00 00 00 32 01 01 01 00 00 00 00 00 00 01 20 21 21 21 21 21 21 24 01 00 00 00 00 00 00 01 22 36 36 36 36 36 36 36 36 36 18 01 00 00 00 00 00 00 00 00 00 22 36 36 36 50
32 01 32 32 01 32 01 32 32 32 01 32 01 22 18 00 00 00 00 00 00 00 00 00 00 00 00 00 32 00 32 01 00 00 00 00 00 00 01 22 36 36 36 36 35 36 18 01 00 00 00 00 00 00 01 22 36 36 36 36 36 36 36 36 36 18 01 00 00 00 00 00 00 00 00 00 22 36 36 36 51
32 01 32 32 01 32 01 01 32 32 01 32 01 22 18 00 00 00 00 00 00 00 00 00 00 00 00 00 32 01 01 01 00 00 00 00 00 00 01 22 36 36 36 36 36 36 18 01 00 00 00 00 00 00 01 22 36 36 36 36 36 36 36 36 36 18 01 01 01 00 00 00 00 20 21 21 25 36 36 36 52
32 01 01 01 01 32 32 01 01 32 01 32 01 22 18 00 00 00 00 00 00 00 00 00 00 00 00 00 32 01 32 00 00 00 00 00 00 00 01 22 36 36 35 36 36 35 18 01 00 00 00 00 00 00 01 22 36 36 35 36 36 36 36 36 36 17 21 24 01 00 00 00 01 22 35 36 36 36 36 36 53
32 01 32 32 01 01 01 32 01 32 01 32 01 22 18 00 00 00 00 00 00 00 00 00 00 00 00 00 32 01 01 01 00 01 01 01 01 01 01 22 36 36 36 36 36 36 18 01 01 01 01 01 01 01 01 22 36 36 36 36 36 36 36 36 36 36 36 18 01 01 01 01 20 25 36 35 35 36 36 36 54
32 01 32 32 32 32 32 01 01 32 01 32 01 22 18 00 00 00 00 00 00 00 00 00 00 00 00 00 32 00 32 01 00 01 20 21 21 21 21 25 36 36 36 35 36 36 17 21 28 29 21 21 28 29 21 25 36 36 36 36 36 36 36 36 36 35 35 17 21 21 21 21 25 36 36 36 35 36 36 36 55
32 01 32 01 32 32 32 01 32 32 01 32 01 22 18 00 00 00 00 00 00 00 00 00 00 00 00 00 32 01 01 01 00 01 22 36 36 36 36 36 35 36 36 36 36 36 36 36 30 31 36 36 30 31 36 36 36 36 36 36 35 36 36 36 36 36 36 36 36 36 36 36 36 36 36 36 36 36 36 36 56
32 01 32 01 01 01 01 01 01 01 01 32 01 22 18 00 32 32 32 32 32 32 32 32 32 32 32 32 32 01 32 00 00 01 22 36 36 36 36 36 36 36 36 36 36 36 36 36 36 36 35 36 36 36 36 36 36 36 36 36 36 36 36 36 36 36 36 36 36 36 36 36 36 36 36 36 36 36 36 36 57
32 01 32 32 32 32 32 32 01 32 32 32 01 22 18 01 01 01 01 01 01 01 01 01 01 01 01 01 01 01 01 01 01 01 22 36 36 35 36 36 36 36 36 36 36 36 36 36 36 36 36 36 36 36 36 36 36 36 36 36 36 35 36 36 36 36 36 36 36 36 36 36 36 36 36 36 36 36 36 36 58
32 01 01 01 01 01 01 01 01 01 01 01 01 22 17 21 21 21 21 21 21 21 21 21 21 21 21 21 21 21 21 21 21 21 25 36 36 36 36 36 36 36 36 36 36 36 36 36 36 36 36 36 36 36 36 36 36 36 36 36 36 36 36 36 36 36 36 36 36 36 36 36 36 36 36 36 36 36 36 36 59
21 21 21 21 21 21 21 21 21 21 21 21 21 25 36 36 36 36 36 36 36 36 36 36 36 36 36 36 36 36 36 36 36 36 36 36 36 36 36 36 36 36 35 36 36 36 36 36 36 35 36 36 36 36 36 36 36 36 36 36 36 36 36 36 36 36 36 36 36 36 36 36 36 36 36 36 36 36 36 36 60
36 36 36 36 36 36 36 35 36 36 36 36 36 36 36 36 36 36 36 36 35 36 36 36 36 36 36 36 36 36 36 36 36 36 36 36 36 36 36 36 36 36 36 36 36 36 36 36 36 36 36 36 36 36 36 36 36 36 36 36 36 36 36 36 36 36 36 36 36 36 36 36 36 36 36 36 36 36 36 36 61
36 36 36 36 36 36 36 36 36 36 36 36 36 36 36 36 36 36 36 36 36 36 36 36 35 36 36 36 36 36 36 36 36 36 36 36 36 36 36 36 36 36 36 36 36 36 36 36 36 36 36 36 36 36 36 36 36 36 36 36 36 36 36 36 36 36 36 36 36 36 36 36 36 35 36 36 36 36 36 36 62
36 36 36 36 36 36 36 36 36 36 36 36 36 36 36 36 36 36 36 36 36 36 35 35 35 35 35 36 36 36 36 36 35 36 36 36 36 36 36 36 36 36 36 36 36 36 36 36 36 36 36 36 36 36 36 36 36 36 36 36 36 36 36 35 36 36 36 36 36 36 36 36 36 36 36 36 36 36 36 36 63
36 36 36 36 36 36 36 36 36 36 36 36 36 36 36 36 36 36 36 36 35 36 36 36 36 36 36 36 36 36 36 36 36 36 36 36 36 36 36 36 36 36 36 36 36 36 36 36 36 36 36 36 36 36 36 36 36 36 36 36 36 36 36 36 36 36 36 36 36 36 36 36 36 36 36 36 36 36 36 36 64
36 36 36 36 36 36 36 36 36 36 36 36 36 36 36 36 36 36 36 36 36 36 36 36 36 36 36 36 36 36 35 36 36 36 36 36 36 36 36 36 36 36 36 36 36 36 36 36 36 36 36 36 36 36 36 36 36 36 36 36 36 36 36 36 36 36 36 36 36 36 36 36 36 36 36 36 36 36 36 36 65
36 36 36 36 36 36 35 35 36 36 36 36 36 36 36 36 36 36 36 36 36 36 36 36 36 36 36 36 36 36 36 36 36 36 36 36 36 36 36 36 36 36 36 36 36 36 36 36 36 36 36 36 36 36 36 36 36 36 36 36 36 36 36 36 36 36 36 36 36 36 36 36 36 36 36 36 36 36 36 36 66
36 36 35 36 36 36 36 36 36 36 36 36 36 36 36 36 36 36 36 36 36 36 36 36 36 36 36 36 36 36 36 36 36 36 36 36 36 36 36 36 36 36 36 36 36 36 36 36 36 36 36 36 36 36 36 36 36 36 36 36 36 36 36 36 36 36 36 36 36 36 36 36 36 36 36 36 36 36 36 36 67
36 36 36 36 36 36 36 36 36 36 36 36 36 36 36 36 36 36 36 36 36 36 36 36 36 36 36 36 36 36 36 36 36 36 36 36 36 36 36 36 36 36 36 36 36 36 36 36 36 36 36 36 35 36 36 36 36 36 36 36 36 36 36 36 36 36 36 36 36 36 36 36 36 36 36 36 36 36 36 36 68
36 36 36 36 36 36 36 36 36 36 36 36 36 36 36 36 36 36 36 36 36 36 36 36 36 36 36 36 36 36 36 36 36 36 36 36 36 36 36 36 36 36 36 36 36 36 36 36 36 36 36 36 36 36 36 36 36 36 36 36 36 36 36 36 36 36 36 36 36 36 36 36 36 36 36 36 36 36 36 36 69
36 36 36 36 36 36 36 36 36 36 36 36 36 36 36 36 36 35 35 36 36 36 36 36 36 36 36 36 36 36 36 36 36 36 36 36 36 36 36 36 36 36 36 36 36 36 36 36 36 36 36 36 36 36 36 36 36 36 36 36 36 36 36 36 36 36 35 36 36 36 36 36 36 36 36 36 36 36 36 36 70
36 36 36 36 36 36 36 36 36 36 36 36 36 36 36 36 36 36 36 36 36 36 36 36 36 36 36 36 36 36 36 36 36 36 36 36 36 36 36 36 36 36 36 36 36 36 36 36 36 36 36 36 36 36 36 36 36 36 36 36 36 36 36 36 36 36 36 36 36 36 01 01 01 01 01 01 01 01 01 01 71
36 36 36 36 36 36 36 36 36 36 36 36 36 36 36 36 36 36 36 36 36 36 36 36 36 36 36 36 36 36 36 36 36 36 36 36 36 36 36 36 36 36 36 36 36 36 36 36 36 36 36 36 36 36 36 36 36 36 36 36 36 36 36 36 36 36 36 36 36 36 01 00 00 00 00 00 00 00 00 00 72
36 35 36 36 36 36 36 36 36 36 36 36 36 36 36 36 36 36 36 36 36 36 36 36 36 36 36 36 36 36 36 36 36 36 36 36 36 36 36 36 36 36 36 36 36 36 36 36 36 36 36 36 36 36 36 36 36 36 36 36 36 36 36 36 36 36 36 36 36 36 01 00 00 00 00 00 00 00 00 00 73
36 35 36 36 36 36 36 36 36 36 36 36 36 36 36 36 36 36 36 36 36 36 36 36 36 36 36 36 36 36 36 36 36 36 36 36 36 36 36 36 36 36 36 36 36 36 36 36 36 36 36 36 36 36 36 36 36 36 36 36 36 36 36 36 36 36 36 36 36 36 01 00 00 00 00 00 00 00 00 00 74
36 36 36 36 36 36 36 36 36 36 36 36 36 36 36 36 36 36 36 36 36 36 36 36 36 36 36 36 36 36 36 36 36 36 36 36 36 36 36 36 36 36 36 36 36 36 36 36 36 36 36 36 36 36 36 36 36 36 36 36 36 36 36 36 36 36 36 36 36 36 01 00 00 00 00 00 00 00 00 00 75
36 36 36 36 36 36 36 36 36 36 36 36 36 36 36 36 36 36 36 36 36 36 36 36 36 36 36 36 36 36 36 36 36 36 36 36 36 36 36 36 36 36 36 36 36 36 36 36 36 36 36 36 36 36 36 36 36 36 36 36 36 36 36 36 36 36 36 36 36 36 01 00 00 00 00 00 00 00 00 00 76
36 36 36 36 36 36 36 36 36 36 36 36 36 36 36 36 36 36 36 35 36 36 36 36 36 36 36 36 36 36 36 36 36 36 36 36 36 36 36 36 36 36 36 36 36 36 36 36 36 36 36 36 36 36 36 36 36 36 36 36 36 36 36 36 36 36 36 36 36 36 01 00 00 00 00 00 00 00 00 00 77
36 36 36 36 36 36 36 36 36 36 36 36 36 36 36 36 36 36 36 36 36 36 36 36 36 36 36 36 36 36 36 36 36 36 36 36 36 36 36 36 36 36 36 36 35 36 36 36 36 36 36 36 36 36 36 36 36 36 36 36 36 36 36 36 36 36 36 36 36 36 01 00 00 00 00 00 00 00 00 00 78
36 36 36 36 36 36 36 36 36 36 36 36 36 36 36 36 36 36 36 36 36 36 36 36 36 36 36 36 36 36 36 36 36 36 36 36 36 36 36 36 36 36 36 36 36 36 36 36 36 36 36 36 36 36 36 36 36 36 36 36 36 36 36 36 36 36 36 36 36 36 01 00 00 00 00 00 00 00 00 00 79 
36 36 36 36 36 36 36 36 36 36 36 36 36 36 36 36 36 36 36 36 36 36 36 36 36 36 36 36 36 36 36 36 36 36 36 36 36 36 36 36 36 36 36 36 36 36 36 36 36 36 36 36 36 36 36 36 36 36 36 36 36 36 36 36 36 36 36 36 36 36 01 00 00 00 00 00 00 00 00 00 80